Crime Category,District,2010,2011,2012,Crimes Over the Years,Population,Crime Percentage
Abduction / Kidnapping,Anuradhapura,51,61,68,180,860575.0,0.02091624785753711
Arson,Anuradhapura,21,21,47,89,860575.0,0.010341922551782238
Mischief  over Rs.5000/=,Anuradhapura,92,79,107,278,860575.0,0.03230398280219621
H.B. & Theft,Anuradhapura,720,671,834,2225,860575.0,0.25854806379455597
Grevious  Hurt,Anuradhapura,135,81,108,324,860575.0,0.0376492461435668
Hurt  by Knife etc.,Anuradhapura,69,63,72,204,860575.0,0.023705080905208727
Homicide/Abet. To commit suicide,Anuradhapura,33,44,24,101,860575.0,0.011736339075618047
Attempted Homicide,Anuradhapura,13,5,15,33,860575.0,0.0038346454405484703
Rape / Incest,Anuradhapura,117,155,199,471,860575.0,0.05473084856055544
Riot,Anuradhapura,2,0,4,6,860575.0,0.0006972082619179038
Robbery,Anuradhapura,239,215,242,696,860575.0,0.08087615838247683
Unnatural Offence/Grve Sexual Abuse,Anuradhapura,23,31,36,90,860575.0,0.010458123928768555
Extortion,Anuradhapura,1,0,9,10,860575.0,0.001162013769863173
"Cheating/Misappropriation C.B. Trust over Rs.100,000/=",Anuradhapura,43,228,270,541,860575.0,0.06286494494959766
Theft of Property including praedial produce over Rs. 5000/ & cycle cattle theft  irrrespective of their value ,Anuradhapura,425,463,584,1472,860575.0,0.17104842692385905
Counterfeiting Currency,Anuradhapura,3,4,6,13,860575.0,0.0015106179008221247
Offences against  State,Anuradhapura,0,0,0,0,860575.0,0.0
Cruelty to Children & sexual  exploitation of children ,Anuradhapura,27,14,23,64,860575.0,0.007436888127124307
Procuration / Trafficking,Anuradhapura,0,1,2,3,860575.0,0.0003486041309589519
Offences  under the  Offensive weapons Act.,Anuradhapura,10,4,4,18,860575.0,0.002091624785753711
Possession of  Automatic or  Repeater Shot Guns,Anuradhapura,0,2,1,3,860575.0,0.0003486041309589519
"Offences under the  Poisons, Opium & Dangerous Drugs Ord. Quantity  as  indicated in Circular NO. 1540/2000",Anuradhapura,4,2,7,13,860575.0,0.0015106179008221247
Abduction / Kidnapping,Ampara,16,20,29,65,649402.0,0.01000920847179405
Arson,Ampara,41,21,31,93,649402.0,0.014320867505797643
Mischief  over Rs.5000/=,Ampara,37,38,36,111,649402.0,0.01709264831337138
H.B. & Theft,Ampara,241,227,239,707,649402.0,0.10886939060859067
Grevious  Hurt,Ampara,98,92,69,259,649402.0,0.03988284606453321
Hurt  by Knife etc.,Ampara,73,48,38,159,649402.0,0.024484063800234677
Homicide/Abet. To commit suicide,Ampara,19,11,16,46,649402.0,0.007083439841577328
Attempted Homicide,Ampara,7,9,12,28,649402.0,0.0043116590340035905
Rape / Incest,Ampara,47,49,37,133,649402.0,0.020480380411517056
Riot,Ampara,0,3,1,4,649402.0,0.0006159512905719415
Robbery,Ampara,45,45,66,156,649402.0,0.024022100332305722
Unnatural Offence/Grve Sexual Abuse,Ampara,14,31,35,80,649402.0,0.01231902581143883
Extortion,Ampara,0,3,2,5,649402.0,0.0007699391132149269
"Cheating/Misappropriation C.B. Trust over Rs.100,000/=",Ampara,42,145,232,419,649402.0,0.06452089768741089
Theft of Property including praedial produce over Rs. 5000/ & cycle cattle theft  irrrespective of their value ,Ampara,187,156,242,585,649402.0,0.09008287624614646
Counterfeiting Currency,Ampara,0,2,1,3,649402.0,0.00046196346792895613
Offences against  State,Ampara,1,0,0,1,649402.0,0.00015398782264298538
Cruelty to Children & sexual  exploitation of children ,Ampara,2,1,1,4,649402.0,0.0006159512905719415
Procuration / Trafficking,Ampara,2,0,2,4,649402.0,0.0006159512905719415
Offences  under the  Offensive weapons Act.,Ampara,13,3,1,17,649402.0,0.002617792984930752
Possession of  Automatic or  Repeater Shot Guns,Ampara,1,0,0,1,649402.0,0.00015398782264298538
"Offences under the  Poisons, Opium & Dangerous Drugs Ord. Quantity  as  indicated in Circular NO. 1540/2000",Ampara,6,2,1,9,649402.0,0.0013858904037868684
Abduction / Kidnapping,Badulla (Badulla & Bandarawela ),26,27,38,91,815405.0,0.011160098356031664
Arson,Badulla (Badulla & Bandarawela ),18,12,14,44,815405.0,0.00539609151280652
Mischief  over Rs.5000/=,Badulla (Badulla & Bandarawela ),27,33,42,102,815405.0,0.012509121234233296
H.B. & Theft,Badulla (Badulla & Bandarawela ),402,399,359,1160,815405.0,0.1422605944285355
Grevious  Hurt,Badulla (Badulla & Bandarawela ),68,90,112,270,815405.0,0.03311237973767637
Hurt  by Knife etc.,Badulla (Badulla & Bandarawela ),86,75,85,246,815405.0,0.030169057094327358
Homicide/Abet. To commit suicide,Badulla (Badulla & Bandarawela ),19,32,28,79,815405.0,0.009688437034357159
Attempted Homicide,Badulla (Badulla & Bandarawela ),16,22,11,49,815405.0,0.006009283730170897
Rape / Incest,Badulla (Badulla & Bandarawela ),54,71,73,198,815405.0,0.024282411807629335
Riot,Badulla (Badulla & Bandarawela ),6,3,3,12,815405.0,0.0014716613216745054
Robbery,Badulla (Badulla & Bandarawela ),79,67,128,274,815405.0,0.03360293351156787
Unnatural Offence/Grve Sexual Abuse,Badulla (Badulla & Bandarawela ),39,17,25,81,815405.0,0.009933713921302911
Extortion,Badulla (Badulla & Bandarawela ),0,0,1,1,815405.0,0.00012263844347287545
"Cheating/Misappropriation C.B. Trust over Rs.100,000/=",Badulla (Badulla & Bandarawela ),3,81,138,222,815405.0,0.027225734450978346
Theft of Property including praedial produce over Rs. 5000/ & cycle cattle theft  irrrespective of their value ,Badulla (Badulla & Bandarawela ),164,194,296,654,815405.0,0.08020554203126054
Counterfeiting Currency,Badulla (Badulla & Bandarawela ),0,2,1,3,815405.0,0.00036791533041862634
Offences against  State,Badulla (Badulla & Bandarawela ),0,0,0,0,815405.0,0.0
Cruelty to Children & sexual  exploitation of children ,Badulla (Badulla & Bandarawela ),6,12,2,20,815405.0,0.002452768869457509
Procuration / Trafficking,Badulla (Badulla & Bandarawela ),0,1,0,1,815405.0,0.00012263844347287545
Offences  under the  Offensive weapons Act.,Badulla (Badulla & Bandarawela ),2,2,3,7,815405.0,0.0008584691043101282
Possession of  Automatic or  Repeater Shot Guns,Badulla (Badulla & Bandarawela ),0,0,0,0,815405.0,0.0
"Offences under the  Poisons, Opium & Dangerous Drugs Ord. Quantity  as  indicated in Circular NO. 1540/2000",Badulla (Badulla & Bandarawela ),3,9,20,32,815405.0,0.003924430191132014
Abduction / Kidnapping,Batticaloa,21,13,21,55,526567.0,0.010445014594534029
Arson,Batticaloa,30,18,33,81,526567.0,0.01538265785740466
Mischief  over Rs.5000/=,Batticaloa,45,26,38,109,526567.0,0.0207001198328038
H.B. & Theft,Batticaloa,237,271,227,735,526567.0,0.13958337685422748
Grevious  Hurt,Batticaloa,39,36,56,131,526567.0,0.024878125670617417
Hurt  by Knife etc.,Batticaloa,69,70,89,228,526567.0,0.04329933322825016
Homicide/Abet. To commit suicide,Batticaloa,9,16,11,36,526567.0,0.0068367368255131825
Attempted Homicide,Batticaloa,5,5,2,12,526567.0,0.002278912275171061
Rape / Incest,Batticaloa,40,41,52,133,526567.0,0.025257944383145922
Riot,Batticaloa,0,4,0,4,526567.0,0.0007596374250570203
Robbery,Batticaloa,69,75,89,233,526567.0,0.04424888000957143
Unnatural Offence/Grve Sexual Abuse,Batticaloa,9,7,2,18,526567.0,0.0034183684127565912
Extortion,Batticaloa,5,2,4,11,526567.0,0.0020890029189068056
"Cheating/Misappropriation C.B. Trust over Rs.100,000/=",Batticaloa,10,213,225,448,526567.0,0.08507939160638628
Theft of Property including praedial produce over Rs. 5000/ & cycle cattle theft  irrrespective of their value ,Batticaloa,269,249,221,739,526567.0,0.1403430142792845
Counterfeiting Currency,Batticaloa,1,0,1,2,526567.0,0.0003798187125285101
Offences against  State,Batticaloa,4,0,0,4,526567.0,0.0007596374250570203
Cruelty to Children & sexual  exploitation of children ,Batticaloa,10,7,6,23,526567.0,0.004367915194077867
Procuration / Trafficking,Batticaloa,1,0,3,4,526567.0,0.0007596374250570203
Offences  under the  Offensive weapons Act.,Batticaloa,16,3,1,20,526567.0,0.0037981871252851015
Possession of  Automatic or  Repeater Shot Guns,Batticaloa,2,2,1,5,526567.0,0.0009495467813212754
"Offences under the  Poisons, Opium & Dangerous Drugs Ord. Quantity  as  indicated in Circular NO. 1540/2000",Batticaloa,0,1,3,4,526567.0,0.0007596374250570203
Abduction / Kidnapping,"Colombo (Colombo South, North, Central) Mt. Laviniya, Nugegoda",108,120,154,382,2324349.0,0.01643470924547045
Arson,"Colombo (Colombo South, North, Central) Mt. Laviniya, Nugegoda",30,23,22,75,2324349.0,0.0032267099303934137
Mischief  over Rs.5000/=,"Colombo (Colombo South, North, Central) Mt. Laviniya, Nugegoda",164,132,140,436,2324349.0,0.01875794039535371
H.B. & Theft,"Colombo (Colombo South, North, Central) Mt. Laviniya, Nugegoda",3649,3437,2996,10082,2324349.0,0.43375586024301854
Grevious  Hurt,"Colombo (Colombo South, North, Central) Mt. Laviniya, Nugegoda",149,274,248,671,2324349.0,0.028868298177253074
Hurt  by Knife etc.,"Colombo (Colombo South, North, Central) Mt. Laviniya, Nugegoda",345,346,379,1070,2324349.0,0.04603439500694603
Homicide/Abet. To commit suicide,"Colombo (Colombo South, North, Central) Mt. Laviniya, Nugegoda",76,70,62,208,2324349.0,0.008948742206957733
Attempted Homicide,"Colombo (Colombo South, North, Central) Mt. Laviniya, Nugegoda",17,21,21,59,2324349.0,0.0025383451452428187
Rape / Incest,"Colombo (Colombo South, North, Central) Mt. Laviniya, Nugegoda",87,111,120,318,2324349.0,0.013681250104868073
Riot,"Colombo (Colombo South, North, Central) Mt. Laviniya, Nugegoda",1,12,3,16,2324349.0,0.0006883647851505948
Robbery,"Colombo (Colombo South, North, Central) Mt. Laviniya, Nugegoda",1436,1613,1542,4591,2324349.0,0.19751767053914882
Unnatural Offence/Grve Sexual Abuse,"Colombo (Colombo South, North, Central) Mt. Laviniya, Nugegoda",25,31,23,79,2324349.0,0.003398801126681062
Extortion,"Colombo (Colombo South, North, Central) Mt. Laviniya, Nugegoda",21,45,37,103,2324349.0,0.004431348304406954
"Cheating/Misappropriation C.B. Trust over Rs.100,000/=","Colombo (Colombo South, North, Central) Mt. Laviniya, Nugegoda",281,1427,1736,3444,2324349.0,0.14817052000366554
Theft of Property including praedial produce over Rs. 5000/ & cycle cattle theft  irrrespective of their value ,"Colombo (Colombo South, North, Central) Mt. Laviniya, Nugegoda",3287,3261,2809,9357,2324349.0,0.40256433091588223
Counterfeiting Currency,"Colombo (Colombo South, North, Central) Mt. Laviniya, Nugegoda",12,8,4,24,2324349.0,0.0010325471777258924
Offences against  State,"Colombo (Colombo South, North, Central) Mt. Laviniya, Nugegoda",2,2,0,4,2324349.0,0.0001720911962876487
Cruelty to Children & sexual  exploitation of children ,"Colombo (Colombo South, North, Central) Mt. Laviniya, Nugegoda",33,53,52,138,2324349.0,0.00593714627192388
Procuration / Trafficking,"Colombo (Colombo South, North, Central) Mt. Laviniya, Nugegoda",4,6,1,11,2324349.0,0.00047325078979103393
Offences  under the  Offensive weapons Act.,"Colombo (Colombo South, North, Central) Mt. Laviniya, Nugegoda",38,33,21,92,2324349.0,0.003958097514615921
Possession of  Automatic or  Repeater Shot Guns,"Colombo (Colombo South, North, Central) Mt. Laviniya, Nugegoda",5,5,6,16,2324349.0,0.0006883647851505948
"Offences under the  Poisons, Opium & Dangerous Drugs Ord. Quantity  as  indicated in Circular NO. 1540/2000","Colombo (Colombo South, North, Central) Mt. Laviniya, Nugegoda",326,470,573,1369,2324349.0,0.058898211929447775
Abduction / Kidnapping,Galle (Galle/Elpitiya),60,57,73,190,1063334.0,0.017868327355280655
Arson,Galle (Galle/Elpitiya),36,27,38,101,1063334.0,0.009498426646754453
Mischief  over Rs.5000/=,Galle (Galle/Elpitiya),65,44,32,141,1063334.0,0.01326017977418196
H.B. & Theft,Galle (Galle/Elpitiya),867,727,748,2342,1063334.0,0.2202506456108805
Grevious  Hurt,Galle (Galle/Elpitiya),83,74,81,238,1063334.0,0.022382431108193664
Hurt  by Knife etc.,Galle (Galle/Elpitiya),146,124,110,380,1063334.0,0.03573665471056131
Homicide/Abet. To commit suicide,Galle (Galle/Elpitiya),48,65,50,163,1063334.0,0.015329143994267087
Attempted Homicide,Galle (Galle/Elpitiya),22,11,13,46,1063334.0,0.0043260160965416326
Rape / Incest,Galle (Galle/Elpitiya),128,105,133,366,1063334.0,0.03442004111596168
Riot,Galle (Galle/Elpitiya),0,0,0,0,1063334.0,0.0
Robbery,Galle (Galle/Elpitiya),490,420,481,1391,1063334.0,0.13081496500629153
Unnatural Offence/Grve Sexual Abuse,Galle (Galle/Elpitiya),27,27,33,87,1063334.0,0.008181813052154827
Extortion,Galle (Galle/Elpitiya),1,6,4,11,1063334.0,0.0010344821100425642
"Cheating/Misappropriation C.B. Trust over Rs.100,000/=",Galle (Galle/Elpitiya),334,231,249,814,1063334.0,0.07655167614314975
Theft of Property including praedial produce over Rs. 5000/ & cycle cattle theft  irrrespective of their value ,Galle (Galle/Elpitiya),472,392,363,1227,1063334.0,0.11539177718383876
Counterfeiting Currency,Galle (Galle/Elpitiya),2,4,3,9,1063334.0,0.0008463944536711889
Offences against  State,Galle (Galle/Elpitiya),0,1,0,1,1063334.0,9.404382818568767e-05
Cruelty to Children & sexual  exploitation of children ,Galle (Galle/Elpitiya),25,14,4,43,1063334.0,0.004043884611984569
Procuration / Trafficking,Galle (Galle/Elpitiya),1,0,3,4,1063334.0,0.00037617531274275066
Offences  under the  Offensive weapons Act.,Galle (Galle/Elpitiya),23,19,26,68,1063334.0,0.00639498031662676
Possession of  Automatic or  Repeater Shot Guns,Galle (Galle/Elpitiya),3,4,2,9,1063334.0,0.0008463944536711889
"Offences under the  Poisons, Opium & Dangerous Drugs Ord. Quantity  as  indicated in Circular NO. 1540/2000",Galle (Galle/Elpitiya),55,37,65,157,1063334.0,0.014764881025152962
Abduction / Kidnapping,Gampaha (Kelaniya/Gampha/Negombo Div),96,115,159,370,2304833.0,0.016053223812744783
Arson,Gampaha (Kelaniya/Gampha/Negombo Div),55,30,27,112,2304833.0,0.004859354235209232
Mischief  over Rs.5000/=,Gampaha (Kelaniya/Gampha/Negombo Div),146,138,100,384,2304833.0,0.016660643092145936
H.B. & Theft,Gampaha (Kelaniya/Gampha/Negombo Div),3664,3132,3235,10031,2304833.0,0.4352159136909268
Grevious  Hurt,Gampaha (Kelaniya/Gampha/Negombo Div),143,137,140,420,2304833.0,0.01822257838203462
Hurt  by Knife etc.,Gampaha (Kelaniya/Gampha/Negombo Div),382,423,331,1136,2304833.0,0.04928773581426507
Homicide/Abet. To commit suicide,Gampaha (Kelaniya/Gampha/Negombo Div),83,67,76,226,2304833.0,0.009805482653190057
Attempted Homicide,Gampaha (Kelaniya/Gampha/Negombo Div),17,14,16,47,2304833.0,0.0020391932951324457
Rape / Incest,Gampaha (Kelaniya/Gampha/Negombo Div),159,120,141,420,2304833.0,0.01822257838203462
Riot,Gampaha (Kelaniya/Gampha/Negombo Div),0,0,0,0,2304833.0,0.0
Robbery,Gampaha (Kelaniya/Gampha/Negombo Div),1345,1330,1413,4088,2304833.0,0.177366429585137
Unnatural Offence/Grve Sexual Abuse,Gampaha (Kelaniya/Gampha/Negombo Div),11,16,3,30,2304833.0,0.0013016127415739014
Extortion,Gampaha (Kelaniya/Gampha/Negombo Div),17,27,33,77,2304833.0,0.003340806036706347
"Cheating/Misappropriation C.B. Trust over Rs.100,000/=",Gampaha (Kelaniya/Gampha/Negombo Div),68,760,1266,2094,2304833.0,0.09085256936185833
Theft of Property including praedial produce over Rs. 5000/ & cycle cattle theft  irrrespective of their value ,Gampaha (Kelaniya/Gampha/Negombo Div),2106,1841,1910,5857,2304833.0,0.25411819424661136
Counterfeiting Currency,Gampaha (Kelaniya/Gampha/Negombo Div),5,5,9,19,2304833.0,0.0008243547363301376
Offences against  State,Gampaha (Kelaniya/Gampha/Negombo Div),0,0,0,0,2304833.0,0.0
Cruelty to Children & sexual  exploitation of children ,Gampaha (Kelaniya/Gampha/Negombo Div),59,58,67,184,2304833.0,0.007983224814986596
Procuration / Trafficking,Gampaha (Kelaniya/Gampha/Negombo Div),2,1,2,5,2304833.0,0.00021693545692898358
Offences  under the  Offensive weapons Act.,Gampaha (Kelaniya/Gampha/Negombo Div),23,12,26,61,2304833.0,0.0026466125745335995
Possession of  Automatic or  Repeater Shot Guns,Gampaha (Kelaniya/Gampha/Negombo Div),1,2,3,6,2304833.0,0.00026032254831478025
"Offences under the  Poisons, Opium & Dangerous Drugs Ord. Quantity  as  indicated in Circular NO. 1540/2000",Gampaha (Kelaniya/Gampha/Negombo Div),75,72,75,222,2304833.0,0.009631934287646872
Abduction / Kidnapping,"Jaffna(Jaffna, KKS)",31,18,23,72,583882.0,0.012331258713233154
Arson,"Jaffna(Jaffna, KKS)",6,8,6,20,583882.0,0.0034253496425647647
Mischief  over Rs.5000/=,"Jaffna(Jaffna, KKS)",24,32,46,102,583882.0,0.0174692831770803
H.B. & Theft,"Jaffna(Jaffna, KKS)",191,244,204,639,583882.0,0.10943992107994424
Grevious  Hurt,"Jaffna(Jaffna, KKS)",46,27,42,115,583882.0,0.0196957604447474
Hurt  by Knife etc.,"Jaffna(Jaffna, KKS)",80,46,53,179,583882.0,0.030656879300954645
Homicide/Abet. To commit suicide,"Jaffna(Jaffna, KKS)",28,29,23,80,583882.0,0.013701398570259059
Attempted Homicide,"Jaffna(Jaffna, KKS)",3,5,2,10,583882.0,0.0017126748212823823
Rape / Incest,"Jaffna(Jaffna, KKS)",39,42,60,141,583882.0,0.024148714980081594
Riot,"Jaffna(Jaffna, KKS)",0,0,0,0,583882.0,0.0
Robbery,"Jaffna(Jaffna, KKS)",93,83,91,267,583882.0,0.04572841772823961
Unnatural Offence/Grve Sexual Abuse,"Jaffna(Jaffna, KKS)",1,4,0,5,583882.0,0.0008563374106411912
Extortion,"Jaffna(Jaffna, KKS)",2,1,0,3,583882.0,0.0005138024463847147
"Cheating/Misappropriation C.B. Trust over Rs.100,000/=","Jaffna(Jaffna, KKS)",14,161,211,386,583882.0,0.06610924810149996
Theft of Property including praedial produce over Rs. 5000/ & cycle cattle theft  irrrespective of their value ,"Jaffna(Jaffna, KKS)",324,239,191,754,583882.0,0.12913568152469165
Counterfeiting Currency,"Jaffna(Jaffna, KKS)",1,2,0,3,583882.0,0.0005138024463847147
Offences against  State,"Jaffna(Jaffna, KKS)",0,0,1,1,583882.0,0.00017126748212823822
Cruelty to Children & sexual  exploitation of children ,"Jaffna(Jaffna, KKS)",6,7,9,22,583882.0,0.0037678846068212412
Procuration / Trafficking,"Jaffna(Jaffna, KKS)",0,0,1,1,583882.0,0.00017126748212823822
Offences  under the  Offensive weapons Act.,"Jaffna(Jaffna, KKS)",5,2,2,9,583882.0,0.0015414073391541443
Possession of  Automatic or  Repeater Shot Guns,"Jaffna(Jaffna, KKS)",1,0,0,1,583882.0,0.00017126748212823822
"Offences under the  Poisons, Opium & Dangerous Drugs Ord. Quantity  as  indicated in Circular NO. 1540/2000","Jaffna(Jaffna, KKS)",1,2,3,6,583882.0,0.0010276048927694295
Abduction / Kidnapping,"Kalutara (Kalutara,Panadura)",66,72,72,210,1221948.0,0.01718567402213515
Arson,"Kalutara (Kalutara,Panadura)",33,11,17,61,1221948.0,0.0049920291207154474
Mischief  over Rs.5000/=,"Kalutara (Kalutara,Panadura)",54,49,50,153,1221948.0,0.012520991073269892
H.B. & Theft,"Kalutara (Kalutara,Panadura)",1241,1287,1120,3648,1221948.0,0.2985397087273763
Grevious  Hurt,"Kalutara (Kalutara,Panadura)",46,79,62,187,1221948.0,0.015303433533996538
Hurt  by Knife etc.,"Kalutara (Kalutara,Panadura)",149,178,185,512,1221948.0,0.041900309996824744
Homicide/Abet. To commit suicide,"Kalutara (Kalutara,Panadura)",47,41,35,123,1221948.0,0.010065894784393445
Attempted Homicide,"Kalutara (Kalutara,Panadura)",13,6,7,26,1221948.0,0.002127750117026256
Rape / Incest,"Kalutara (Kalutara,Panadura)",90,89,108,287,1221948.0,0.023487087830251368
Riot,"Kalutara (Kalutara,Panadura)",0,0,0,0,1221948.0,0.0
Robbery,"Kalutara (Kalutara,Panadura)",388,381,390,1159,1221948.0,0.09484855329359351
Unnatural Offence/Grve Sexual Abuse,"Kalutara (Kalutara,Panadura)",31,20,11,62,1221948.0,0.005073865663677996
Extortion,"Kalutara (Kalutara,Panadura)",0,3,4,7,1221948.0,0.0005728558007378383
"Cheating/Misappropriation C.B. Trust over Rs.100,000/=","Kalutara (Kalutara,Panadura)",74,290,301,665,1221948.0,0.054421301070094644
Theft of Property including praedial produce over Rs. 5000/ & cycle cattle theft  irrrespective of their value ,"Kalutara (Kalutara,Panadura)",767,875,725,2367,1221948.0,0.19370709719235188
Counterfeiting Currency,"Kalutara (Kalutara,Panadura)",0,1,0,1,1221948.0,8.183654296254833e-05
Offences against  State,"Kalutara (Kalutara,Panadura)",0,0,0,0,1221948.0,0.0
Cruelty to Children & sexual  exploitation of children ,"Kalutara (Kalutara,Panadura)",32,25,41,98,1221948.0,0.008019981210329735
Procuration / Trafficking,"Kalutara (Kalutara,Panadura)",0,0,0,0,1221948.0,0.0
Offences  under the  Offensive weapons Act.,"Kalutara (Kalutara,Panadura)",12,13,4,29,1221948.0,0.002373259745913902
Possession of  Automatic or  Repeater Shot Guns,"Kalutara (Kalutara,Panadura)",2,4,0,6,1221948.0,0.0004910192577752899
"Offences under the  Poisons, Opium & Dangerous Drugs Ord. Quantity  as  indicated in Circular NO. 1540/2000","Kalutara (Kalutara,Panadura)",60,45,83,188,1221948.0,0.015385270076959084
Abduction / Kidnapping,"Kandy (Kandy, Gampola)",54,51,62,167,1375382.0,0.012142081254516926
Arson,"Kandy (Kandy, Gampola)",23,31,30,84,1375382.0,0.0061073941639486345
Mischief  over Rs.5000/=,"Kandy (Kandy, Gampola)",77,71,68,216,1375382.0,0.01570472785015363
H.B. & Theft,"Kandy (Kandy, Gampola)",856,698,918,2472,1375382.0,0.17973188539620266
Grevious  Hurt,"Kandy (Kandy, Gampola)",117,107,143,367,1375382.0,0.026683495930585104
Hurt  by Knife etc.,"Kandy (Kandy, Gampola)",196,177,226,599,1375382.0,0.04355153695482419
Homicide/Abet. To commit suicide,"Kandy (Kandy, Gampola)",24,31,20,75,1375382.0,0.005453030503525566
Attempted Homicide,"Kandy (Kandy, Gampola)",9,9,13,31,1375382.0,0.002253919274790567
Rape / Incest,"Kandy (Kandy, Gampola)",92,92,123,307,1375382.0,0.02232107152776465
Riot,"Kandy (Kandy, Gampola)",2,0,1,3,1375382.0,0.00021812122014102265
Robbery,"Kandy (Kandy, Gampola)",182,196,285,663,1375382.0,0.048204789651166
Unnatural Offence/Grve Sexual Abuse,"Kandy (Kandy, Gampola)",42,27,53,122,1375382.0,0.008870262952401587
Extortion,"Kandy (Kandy, Gampola)",5,6,7,18,1375382.0,0.0013087273208461359
"Cheating/Misappropriation C.B. Trust over Rs.100,000/=","Kandy (Kandy, Gampola)",418,343,349,1110,1375382.0,0.08070485145217837
Theft of Property including praedial produce over Rs. 5000/ & cycle cattle theft  irrrespective of their value ,"Kandy (Kandy, Gampola)",539,482,631,1652,1375382.0,0.12011208522432312
Counterfeiting Currency,"Kandy (Kandy, Gampola)",1,1,6,8,1375382.0,0.000581656587042727
Offences against  State,"Kandy (Kandy, Gampola)",1,0,0,1,1375382.0,7.270707338034087e-05
Cruelty to Children & sexual  exploitation of children ,"Kandy (Kandy, Gampola)",19,20,28,67,1375382.0,0.004871373916482839
Procuration / Trafficking,"Kandy (Kandy, Gampola)",0,0,1,1,1375382.0,7.270707338034087e-05
Offences  under the  Offensive weapons Act.,"Kandy (Kandy, Gampola)",6,1,5,12,1375382.0,0.0008724848805640906
Possession of  Automatic or  Repeater Shot Guns,"Kandy (Kandy, Gampola)",1,2,1,4,1375382.0,0.0002908282935213635
"Offences under the  Poisons, Opium & Dangerous Drugs Ord. Quantity  as  indicated in Circular NO. 1540/2000","Kandy (Kandy, Gampola)",16,14,6,36,1375382.0,0.0026174546416922718
Abduction / Kidnapping,"Kegalle (Kegalle, Sithawakapura0",48,61,60,169,840648.0,0.020103539174541545
Arson,"Kegalle (Kegalle, Sithawakapura0",43,37,42,122,840648.0,0.014512614078663128
Mischief  over Rs.5000/=,"Kegalle (Kegalle, Sithawakapura0",83,69,58,210,840648.0,0.024980729151797186
H.B. & Theft,"Kegalle (Kegalle, Sithawakapura0",962,1001,997,2960,840648.0,0.35210932518723653
Grevious  Hurt,"Kegalle (Kegalle, Sithawakapura0",66,65,59,190,840648.0,0.022601612089721262
Hurt  by Knife etc.,"Kegalle (Kegalle, Sithawakapura0",272,298,275,845,840648.0,0.10051769587270773
Homicide/Abet. To commit suicide,"Kegalle (Kegalle, Sithawakapura0",36,29,26,91,840648.0,0.010824982632445447
Attempted Homicide,"Kegalle (Kegalle, Sithawakapura0",16,5,3,24,840648.0,0.002854940474491107
Rape / Incest,"Kegalle (Kegalle, Sithawakapura0",78,66,123,267,840648.0,0.03176121277871356
Riot,"Kegalle (Kegalle, Sithawakapura0",0,0,0,0,840648.0,0.0
Robbery,"Kegalle (Kegalle, Sithawakapura0",305,268,279,852,840648.0,0.10135038684443429
Unnatural Offence/Grve Sexual Abuse,"Kegalle (Kegalle, Sithawakapura0",29,27,34,90,840648.0,0.01070602677934165
Extortion,"Kegalle (Kegalle, Sithawakapura0",1,2,1,4,840648.0,0.0004758234124151844
"Cheating/Misappropriation C.B. Trust over Rs.100,000/=","Kegalle (Kegalle, Sithawakapura0",31,163,177,371,840648.0,0.04413262150150836
Theft of Property including praedial produce over Rs. 5000/ & cycle cattle theft  irrrespective of their value ,"Kegalle (Kegalle, Sithawakapura0",528,521,474,1523,840648.0,0.18116976427708148
Counterfeiting Currency,"Kegalle (Kegalle, Sithawakapura0",0,0,1,1,840648.0,0.0001189558531037961
Offences against  State,"Kegalle (Kegalle, Sithawakapura0",0,0,0,0,840648.0,0.0
Cruelty to Children & sexual  exploitation of children ,"Kegalle (Kegalle, Sithawakapura0",14,18,22,54,840648.0,0.006423616067604989
Procuration / Trafficking,"Kegalle (Kegalle, Sithawakapura0",3,1,0,4,840648.0,0.0004758234124151844
Offences  under the  Offensive weapons Act.,"Kegalle (Kegalle, Sithawakapura0",3,4,3,10,840648.0,0.0011895585310379613
Possession of  Automatic or  Repeater Shot Guns,"Kegalle (Kegalle, Sithawakapura0",3,0,1,4,840648.0,0.0004758234124151844
"Offences under the  Poisons, Opium & Dangerous Drugs Ord. Quantity  as  indicated in Circular NO. 1540/2000","Kegalle (Kegalle, Sithawakapura0",3,7,6,16,840648.0,0.0019032936496607377
Abduction / Kidnapping,"Kilinochchi (Kilinochchi, Mankulam )",0,2,7,9,113510.0,0.007928816844330897
Arson,"Kilinochchi (Kilinochchi, Mankulam )",0,1,3,4,113510.0,0.0035239185974803985
Mischief  over Rs.5000/=,"Kilinochchi (Kilinochchi, Mankulam )",2,2,6,10,113510.0,0.008809796493700995
H.B. & Theft,"Kilinochchi (Kilinochchi, Mankulam )",18,58,71,147,113510.0,0.12950400845740462
Grevious  Hurt,"Kilinochchi (Kilinochchi, Mankulam )",7,17,25,49,113510.0,0.043168002819134875
Hurt  by Knife etc.,"Kilinochchi (Kilinochchi, Mankulam )",17,28,40,85,113510.0,0.07488327019645846
Homicide/Abet. To commit suicide,"Kilinochchi (Kilinochchi, Mankulam )",9,8,4,21,113510.0,0.01850057263677209
Attempted Homicide,"Kilinochchi (Kilinochchi, Mankulam )",1,1,4,6,113510.0,0.005285877896220597
Rape / Incest,"Kilinochchi (Kilinochchi, Mankulam )",9,31,27,67,113510.0,0.05902563650779667
Riot,"Kilinochchi (Kilinochchi, Mankulam )",1,0,0,1,113510.0,0.0008809796493700996
Robbery,"Kilinochchi (Kilinochchi, Mankulam )",28,40,27,95,113510.0,0.08369306669015945
Unnatural Offence/Grve Sexual Abuse,"Kilinochchi (Kilinochchi, Mankulam )",0,1,0,1,113510.0,0.0008809796493700996
Extortion,"Kilinochchi (Kilinochchi, Mankulam )",6,3,1,10,113510.0,0.008809796493700995
"Cheating/Misappropriation C.B. Trust over Rs.100,000/=","Kilinochchi (Kilinochchi, Mankulam )",3,33,73,109,113510.0,0.09602678178134084
Theft of Property including praedial produce over Rs. 5000/ & cycle cattle theft  irrrespective of their value ,"Kilinochchi (Kilinochchi, Mankulam )",119,139,140,398,113510.0,0.35062990044929965
Counterfeiting Currency,"Kilinochchi (Kilinochchi, Mankulam )",0,0,0,0,113510.0,0.0
Offences against  State,"Kilinochchi (Kilinochchi, Mankulam )",3,0,0,3,113510.0,0.0026429389481102987
Cruelty to Children & sexual  exploitation of children ,"Kilinochchi (Kilinochchi, Mankulam )",3,4,7,14,113510.0,0.012333715091181394
Procuration / Trafficking,"Kilinochchi (Kilinochchi, Mankulam )",0,0,1,1,113510.0,0.0008809796493700996
Offences  under the  Offensive weapons Act.,"Kilinochchi (Kilinochchi, Mankulam )",7,2,4,13,113510.0,0.011452735441811294
Possession of  Automatic or  Repeater Shot Guns,"Kilinochchi (Kilinochchi, Mankulam )",1,0,1,2,113510.0,0.0017619592987401993
"Offences under the  Poisons, Opium & Dangerous Drugs Ord. Quantity  as  indicated in Circular NO. 1540/2000","Kilinochchi (Kilinochchi, Mankulam )",8,1,0,9,113510.0,0.007928816844330897
Abduction / Kidnapping,"Kurunegala (Kurunegala, Kuliyapitiya, Nikaweratiya )",65,96,91,252,1618465.0,0.015570308903807003
Arson,"Kurunegala (Kurunegala, Kuliyapitiya, Nikaweratiya )",96,54,53,203,1618465.0,0.012542748839177862
Mischief  over Rs.5000/=,"Kurunegala (Kurunegala, Kuliyapitiya, Nikaweratiya )",183,71,60,314,1618465.0,0.01940109918966428
H.B. & Theft,"Kurunegala (Kurunegala, Kuliyapitiya, Nikaweratiya )",1343,1022,952,3317,1618465.0,0.20494728029336437
Grevious  Hurt,"Kurunegala (Kurunegala, Kuliyapitiya, Nikaweratiya )",77,120,73,270,1618465.0,0.016682473825507502
Hurt  by Knife etc.,"Kurunegala (Kurunegala, Kuliyapitiya, Nikaweratiya )",254,229,191,674,1618465.0,0.041644397623674285
Homicide/Abet. To commit suicide,"Kurunegala (Kurunegala, Kuliyapitiya, Nikaweratiya )",57,59,58,174,1618465.0,0.010750927576438168
Attempted Homicide,"Kurunegala (Kurunegala, Kuliyapitiya, Nikaweratiya )",17,11,12,40,1618465.0,0.002471477603778889
Rape / Incest,"Kurunegala (Kurunegala, Kuliyapitiya, Nikaweratiya )",164,170,207,541,1618465.0,0.033426734591109473
Riot,"Kurunegala (Kurunegala, Kuliyapitiya, Nikaweratiya )",0,1,1,2,1618465.0,0.00012357388018894447
Robbery,"Kurunegala (Kurunegala, Kuliyapitiya, Nikaweratiya )",453,348,297,1098,1618465.0,0.0678420602237305
Unnatural Offence/Grve Sexual Abuse,"Kurunegala (Kurunegala, Kuliyapitiya, Nikaweratiya )",60,94,74,228,1618465.0,0.014087422341539667
Extortion,"Kurunegala (Kurunegala, Kuliyapitiya, Nikaweratiya )",17,11,11,39,1618465.0,0.0024096906636844172
"Cheating/Misappropriation C.B. Trust over Rs.100,000/=","Kurunegala (Kurunegala, Kuliyapitiya, Nikaweratiya )",197,500,537,1234,1618465.0,0.07624508407657873
Theft of Property including praedial produce over Rs. 5000/ & cycle cattle theft  irrrespective of their value ,"Kurunegala (Kurunegala, Kuliyapitiya, Nikaweratiya )",1030,735,668,2433,1618465.0,0.15032762524985094
Counterfeiting Currency,"Kurunegala (Kurunegala, Kuliyapitiya, Nikaweratiya )",2,6,1,9,1618465.0,0.0005560824608502502
Offences against  State,"Kurunegala (Kurunegala, Kuliyapitiya, Nikaweratiya )",1,0,0,1,1618465.0,6.178694009447223e-05
Cruelty to Children & sexual  exploitation of children ,"Kurunegala (Kurunegala, Kuliyapitiya, Nikaweratiya )",15,10,7,32,1618465.0,0.0019771820830231115
Procuration / Trafficking,"Kurunegala (Kurunegala, Kuliyapitiya, Nikaweratiya )",1,0,1,2,1618465.0,0.00012357388018894447
Offences  under the  Offensive weapons Act.,"Kurunegala (Kurunegala, Kuliyapitiya, Nikaweratiya )",15,13,10,38,1618465.0,0.002347903723589945
Possession of  Automatic or  Repeater Shot Guns,"Kurunegala (Kurunegala, Kuliyapitiya, Nikaweratiya )",0,2,0,2,1618465.0,0.00012357388018894447
"Offences under the  Poisons, Opium & Dangerous Drugs Ord. Quantity  as  indicated in Circular NO. 1540/2000","Kurunegala (Kurunegala, Kuliyapitiya, Nikaweratiya )",18,3,10,31,1618465.0,0.001915395142928639
Abduction / Kidnapping,Mannar ,9,4,6,19,,
Arson,Mannar ,3,5,7,15,,
Mischief  over Rs.5000/=,Mannar ,6,5,13,24,,
H.B. & Theft,Mannar ,33,63,43,139,,
Grevious  Hurt,Mannar ,14,11,11,36,,
Hurt  by Knife etc.,Mannar ,23,18,15,56,,
Homicide/Abet. To commit suicide,Mannar ,4,1,4,9,,
Attempted Homicide,Mannar ,1,0,3,4,,
Rape / Incest,Mannar ,13,7,15,35,,
Riot,Mannar ,0,0,0,0,,
Robbery,Mannar ,14,9,10,33,,
Unnatural Offence/Grve Sexual Abuse,Mannar ,0,0,0,0,,
Extortion,Mannar ,0,1,0,1,,
"Cheating/Misappropriation C.B. Trust over Rs.100,000/=",Mannar ,3,31,62,96,,
Theft of Property including praedial produce over Rs. 5000/ & cycle cattle theft  irrrespective of their value ,Mannar ,69,50,61,180,,
Counterfeiting Currency,Mannar ,0,0,0,0,,
Offences against  State,Mannar ,0,1,0,1,,
Cruelty to Children & sexual  exploitation of children ,Mannar ,2,4,7,13,,
Procuration / Trafficking,Mannar ,0,0,0,0,,
Offences  under the  Offensive weapons Act.,Mannar ,1,0,2,3,,
Possession of  Automatic or  Repeater Shot Guns,Mannar ,0,0,0,0,,
"Offences under the  Poisons, Opium & Dangerous Drugs Ord. Quantity  as  indicated in Circular NO. 1540/2000",Mannar ,3,12,4,19,,
Abduction / Kidnapping,Matale ,21,30,30,81,484531.0,0.016717196629317834
Arson,Matale ,17,18,14,49,484531.0,0.010112872035019432
Mischief  over Rs.5000/=,Matale ,25,49,29,103,484531.0,0.02125766978789799
H.B. & Theft,Matale ,196,253,269,718,484531.0,0.14818453308457044
Grevious  Hurt,Matale ,28,49,66,143,484531.0,0.029513075530770993
Hurt  by Knife etc.,Matale ,84,96,71,251,484531.0,0.0518026710365281
Homicide/Abet. To commit suicide,Matale ,15,12,14,41,484531.0,0.008461790886444831
Attempted Homicide,Matale ,9,11,7,27,484531.0,0.005572398876439279
Rape / Incest,Matale ,58,60,76,194,484531.0,0.04003871785293408
Riot,Matale ,0,1,0,1,484531.0,0.00020638514357182512
Robbery,Matale ,66,61,85,212,484531.0,0.043753650437226926
Unnatural Offence/Grve Sexual Abuse,Matale ,12,27,22,61,484531.0,0.012589493757881333
Extortion,Matale ,0,1,0,1,484531.0,0.00020638514357182512
"Cheating/Misappropriation C.B. Trust over Rs.100,000/=",Matale ,57,97,92,246,484531.0,0.05077074531866898
Theft of Property including praedial produce over Rs. 5000/ & cycle cattle theft  irrrespective of their value ,Matale ,138,152,165,455,484531.0,0.09390524032518044
Counterfeiting Currency,Matale ,0,0,0,0,484531.0,0.0
Offences against  State,Matale ,0,0,0,0,484531.0,0.0
Cruelty to Children & sexual  exploitation of children ,Matale ,2,2,2,6,484531.0,0.0012383108614309507
Procuration / Trafficking,Matale ,0,1,0,1,484531.0,0.00020638514357182512
Offences  under the  Offensive weapons Act.,Matale ,3,3,0,6,484531.0,0.0012383108614309507
Possession of  Automatic or  Repeater Shot Guns,Matale ,0,1,1,2,484531.0,0.00041277028714365024
"Offences under the  Poisons, Opium & Dangerous Drugs Ord. Quantity  as  indicated in Circular NO. 1540/2000",Matale ,39,29,20,88,484531.0,0.018161892634320612
Abduction / Kidnapping,Matara,66,41,51,158,814048.0,0.019409174888950036
Arson,Matara,23,20,28,71,814048.0,0.008721844412123118
Mischief  over Rs.5000/=,Matara,33,25,26,84,814048.0,0.010318801839694957
H.B. & Theft,Matara,493,447,555,1495,814048.0,0.18365010417076144
Grevious  Hurt,Matara,27,38,40,105,814048.0,0.012898502299618695
Hurt  by Knife etc.,Matara,104,98,101,303,814048.0,0.03722139235032824
Homicide/Abet. To commit suicide,Matara,29,26,29,84,814048.0,0.010318801839694957
Attempted Homicide,Matara,6,7,6,19,814048.0,0.0023340147018357637
Rape / Incest,Matara,87,82,111,280,814048.0,0.034396006132316526
Riot,Matara,0,0,0,0,814048.0,0.0
Robbery,Matara,151,137,196,484,814048.0,0.05945595345728999
Unnatural Offence/Grve Sexual Abuse,Matara,8,8,11,27,814048.0,0.0033167577341876647
Extortion,Matara,0,1,7,8,814048.0,0.0009827430323519008
"Cheating/Misappropriation C.B. Trust over Rs.100,000/=",Matara,7,146,189,342,814048.0,0.04201226463304375
Theft of Property including praedial produce over Rs. 5000/ & cycle cattle theft  irrrespective of their value ,Matara,239,183,258,680,814048.0,0.08353315774991155
Counterfeiting Currency,Matara,2,0,0,2,814048.0,0.0002456857580879752
Offences against  State,Matara,0,0,0,0,814048.0,0.0
Cruelty to Children & sexual  exploitation of children ,Matara,13,25,41,79,814048.0,0.009704587444475018
Procuration / Trafficking,Matara,5,6,5,16,814048.0,0.0019654860647038016
Offences  under the  Offensive weapons Act.,Matara,14,6,7,27,814048.0,0.0033167577341876647
Possession of  Automatic or  Repeater Shot Guns,Matara,1,3,0,4,814048.0,0.0004913715161759504
"Offences under the  Poisons, Opium & Dangerous Drugs Ord. Quantity  as  indicated in Circular NO. 1540/2000",Matara,19,7,11,37,814048.0,0.00454518652462754
Abduction / Kidnapping,Monaragala,17,31,29,77,451058.0,0.0170709753512852
Arson,Monaragala,16,17,16,49,451058.0,0.010863347950817856
Mischief  over Rs.5000/=,Monaragala,31,43,22,96,451058.0,0.02128329394445947
H.B. & Theft,Monaragala,258,295,334,887,451058.0,0.19664876800766198
Grevious  Hurt,Monaragala,23,53,27,103,451058.0,0.022835200794576307
Hurt  by Knife etc.,Monaragala,41,41,37,119,451058.0,0.02638241645198622
Homicide/Abet. To commit suicide,Monaragala,22,15,24,61,451058.0,0.01352375969387529
Attempted Homicide,Monaragala,10,14,13,37,451058.0,0.008202936207760421
Rape / Incest,Monaragala,57,60,77,194,451058.0,0.043009989846095185
Riot,Monaragala,0,0,0,0,451058.0,0.0
Robbery,Monaragala,80,63,78,221,451058.0,0.048995916267974414
Unnatural Offence/Grve Sexual Abuse,Monaragala,22,17,33,72,451058.0,0.015962470458344605
Extortion,Monaragala,1,1,0,2,451058.0,0.000443401957176239
"Cheating/Misappropriation C.B. Trust over Rs.100,000/=",Monaragala,48,46,39,133,451058.0,0.02948623015221989
Theft of Property including praedial produce over Rs. 5000/ & cycle cattle theft  irrrespective of their value ,Monaragala,136,205,174,515,451058.0,0.11417600397288154
Counterfeiting Currency,Monaragala,0,0,0,0,451058.0,0.0
Offences against  State,Monaragala,0,0,0,0,451058.0,0.0
Cruelty to Children & sexual  exploitation of children ,Monaragala,0,5,2,7,451058.0,0.0015519068501168366
Procuration / Trafficking,Monaragala,0,5,0,5,451058.0,0.0011085048929405975
Offences  under the  Offensive weapons Act.,Monaragala,1,5,3,9,451058.0,0.0019953088072930756
Possession of  Automatic or  Repeater Shot Guns,Monaragala,1,0,0,1,451058.0,0.0002217009785881195
"Offences under the  Poisons, Opium & Dangerous Drugs Ord. Quantity  as  indicated in Circular NO. 1540/2000",Monaragala,20,29,44,93,451058.0,0.020618191008695115
Abduction / Kidnapping,Mulllativu,0,2,5,7,92238.0,0.00758906307595568
Arson,Mulllativu,0,0,4,4,92238.0,0.004336607471974675
Mischief  over Rs.5000/=,Mulllativu,0,3,3,6,92238.0,0.006504911207962012
H.B. & Theft,Mulllativu,2,6,30,38,92238.0,0.0411977709837594
Grevious  Hurt,Mulllativu,0,1,15,16,92238.0,0.0173464298878987
Hurt  by Knife etc.,Mulllativu,0,2,7,9,92238.0,0.009757366811943016
Homicide/Abet. To commit suicide,Mulllativu,1,3,3,7,92238.0,0.00758906307595568
Attempted Homicide,Mulllativu,1,1,3,5,92238.0,0.005420759339968342
Rape / Incest,Mulllativu,2,4,9,15,92238.0,0.01626227801990503
Riot,Mulllativu,0,0,0,0,92238.0,0.0
Robbery,Mulllativu,2,10,10,22,92238.0,0.023851341095860706
Unnatural Offence/Grve Sexual Abuse,Mulllativu,0,0,0,0,92238.0,0.0
Extortion,Mulllativu,0,0,0,0,92238.0,0.0
"Cheating/Misappropriation C.B. Trust over Rs.100,000/=",Mulllativu,1,6,13,20,92238.0,0.02168303735987337
Theft of Property including praedial produce over Rs. 5000/ & cycle cattle theft  irrrespective of their value ,Mulllativu,8,23,56,87,92238.0,0.09432121251544916
Counterfeiting Currency,Mulllativu,0,0,0,0,92238.0,0.0
Offences against  State,Mulllativu,0,0,0,0,92238.0,0.0
Cruelty to Children & sexual  exploitation of children ,Mulllativu,1,1,0,2,92238.0,0.0021683037359873374
Procuration / Trafficking,Mulllativu,0,0,0,0,92238.0,0.0
Offences  under the  Offensive weapons Act.,Mulllativu,1,0,1,2,92238.0,0.0021683037359873374
Possession of  Automatic or  Repeater Shot Guns,Mulllativu,0,0,0,0,92238.0,0.0
"Offences under the  Poisons, Opium & Dangerous Drugs Ord. Quantity  as  indicated in Circular NO. 1540/2000",Mulllativu,0,0,0,0,92238.0,0.0
Abduction / Kidnapping,"Nuwara Eliya (Hatton, Nuwara Eliya )",13,6,21,40,711644.0,0.005620787922050913
Arson,"Nuwara Eliya (Hatton, Nuwara Eliya )",8,5,10,23,711644.0,0.0032319530551792753
Mischief  over Rs.5000/=,"Nuwara Eliya (Hatton, Nuwara Eliya )",49,29,32,110,711644.0,0.015457166785640011
H.B. & Theft,"Nuwara Eliya (Hatton, Nuwara Eliya )",283,205,190,678,711644.0,0.09527235527876297
Grevious  Hurt,"Nuwara Eliya (Hatton, Nuwara Eliya )",53,92,96,241,711644.0,0.03386524723035675
Hurt  by Knife etc.,"Nuwara Eliya (Hatton, Nuwara Eliya )",58,70,84,212,711644.0,0.029790175986869838
Homicide/Abet. To commit suicide,"Nuwara Eliya (Hatton, Nuwara Eliya )",14,13,17,44,711644.0,0.006182866714256005
Attempted Homicide,"Nuwara Eliya (Hatton, Nuwara Eliya )",7,0,13,20,711644.0,0.0028103939610254567
Rape / Incest,"Nuwara Eliya (Hatton, Nuwara Eliya )",2,32,43,77,711644.0,0.010820016749948008
Riot,"Nuwara Eliya (Hatton, Nuwara Eliya )",8,1,1,10,711644.0,0.0014051969805127284
Robbery,"Nuwara Eliya (Hatton, Nuwara Eliya )",52,51,48,151,711644.0,0.021218474405742194
Unnatural Offence/Grve Sexual Abuse,"Nuwara Eliya (Hatton, Nuwara Eliya )",13,11,4,28,711644.0,0.003934551545435639
Extortion,"Nuwara Eliya (Hatton, Nuwara Eliya )",4,0,1,5,711644.0,0.0007025984902563642
"Cheating/Misappropriation C.B. Trust over Rs.100,000/=","Nuwara Eliya (Hatton, Nuwara Eliya )",44,87,107,238,711644.0,0.03344368813620293
Theft of Property including praedial produce over Rs. 5000/ & cycle cattle theft  irrrespective of their value ,"Nuwara Eliya (Hatton, Nuwara Eliya )",143,150,154,447,711644.0,0.06281230502891895
Counterfeiting Currency,"Nuwara Eliya (Hatton, Nuwara Eliya )",0,1,2,3,711644.0,0.00042155909415381854
Offences against  State,"Nuwara Eliya (Hatton, Nuwara Eliya )",0,0,0,0,711644.0,0.0
Cruelty to Children & sexual  exploitation of children ,"Nuwara Eliya (Hatton, Nuwara Eliya )",12,5,8,25,711644.0,0.0035129924512818204
Procuration / Trafficking,"Nuwara Eliya (Hatton, Nuwara Eliya )",0,0,0,0,711644.0,0.0
Offences  under the  Offensive weapons Act.,"Nuwara Eliya (Hatton, Nuwara Eliya )",0,1,0,1,711644.0,0.00014051969805127282
Possession of  Automatic or  Repeater Shot Guns,"Nuwara Eliya (Hatton, Nuwara Eliya )",0,0,0,0,711644.0,0.0
"Offences under the  Poisons, Opium & Dangerous Drugs Ord. Quantity  as  indicated in Circular NO. 1540/2000","Nuwara Eliya (Hatton, Nuwara Eliya )",5,0,2,7,711644.0,0.0009836378863589098
Abduction / Kidnapping,Polonnaruwa,23,30,42,95,406088.0,0.02339394416973661
Arson,Polonnaruwa,43,39,17,99,406088.0,0.024378952345304468
Mischief  over Rs.5000/=,Polonnaruwa,43,29,31,103,406088.0,0.025363960520872326
H.B. & Theft,Polonnaruwa,375,298,283,956,406088.0,0.23541695396071785
Grevious  Hurt,Polonnaruwa,47,34,48,129,406088.0,0.03176651366206339
Hurt  by Knife etc.,Polonnaruwa,101,65,74,240,406088.0,0.05910049053407143
Homicide/Abet. To commit suicide,Polonnaruwa,10,6,9,25,406088.0,0.0061563010972991074
Attempted Homicide,Polonnaruwa,9,4,5,18,406088.0,0.004432536790055358
Rape / Incest,Polonnaruwa,78,46,72,196,406088.0,0.048265400602825005
Riot,Polonnaruwa,0,0,0,0,406088.0,0.0
Robbery,Polonnaruwa,93,91,96,280,406088.0,0.06895057228975
Unnatural Offence/Grve Sexual Abuse,Polonnaruwa,14,10,10,34,406088.0,0.008372569492326785
Extortion,Polonnaruwa,2,5,1,8,406088.0,0.0019700163511357145
"Cheating/Misappropriation C.B. Trust over Rs.100,000/=",Polonnaruwa,19,100,124,243,406088.0,0.05983924666574733
Theft of Property including praedial produce over Rs. 5000/ & cycle cattle theft  irrrespective of their value ,Polonnaruwa,219,207,217,643,406088.0,0.15834006422253305
Counterfeiting Currency,Polonnaruwa,0,1,4,5,406088.0,0.0012312602194598215
Offences against  State,Polonnaruwa,0,0,0,0,406088.0,0.0
Cruelty to Children & sexual  exploitation of children ,Polonnaruwa,30,20,41,91,406088.0,0.022408935994168752
Procuration / Trafficking,Polonnaruwa,27,4,1,32,406088.0,0.007880065404542858
Offences  under the  Offensive weapons Act.,Polonnaruwa,7,2,1,10,406088.0,0.002462520438919643
Possession of  Automatic or  Repeater Shot Guns,Polonnaruwa,1,1,3,5,406088.0,0.0012312602194598215
"Offences under the  Poisons, Opium & Dangerous Drugs Ord. Quantity  as  indicated in Circular NO. 1540/2000",Polonnaruwa,5,1,1,7,406088.0,0.0017237643072437502
Abduction / Kidnapping,"Puttlam (Puttlam, Chilaw )",39,46,55,140,762396.0,0.018363160352362816
Arson,"Puttlam (Puttlam, Chilaw )",38,28,21,87,762396.0,0.011411392504682606
Mischief  over Rs.5000/=,"Puttlam (Puttlam, Chilaw )",58,52,26,136,762396.0,0.01783849862800959
H.B. & Theft,"Puttlam (Puttlam, Chilaw )",621,492,438,1551,762396.0,0.2034375836179623
Grevious  Hurt,"Puttlam (Puttlam, Chilaw )",23,43,25,91,762396.0,0.011936054229035828
Hurt  by Knife etc.,"Puttlam (Puttlam, Chilaw )",120,151,105,376,762396.0,0.049318202089202984
Homicide/Abet. To commit suicide,"Puttlam (Puttlam, Chilaw )",34,24,22,80,762396.0,0.010493234487064464
Attempted Homicide,"Puttlam (Puttlam, Chilaw )",13,15,8,36,762396.0,0.00472195551917901
Rape / Incest,"Puttlam (Puttlam, Chilaw )",95,102,92,289,762396.0,0.03790680958452038
Riot,"Puttlam (Puttlam, Chilaw )",0,0,0,0,762396.0,0.0
Robbery,"Puttlam (Puttlam, Chilaw )",167,177,149,493,762396.0,0.06466455752653477
Unnatural Offence/Grve Sexual Abuse,"Puttlam (Puttlam, Chilaw )",27,30,29,86,762396.0,0.011280227073594301
Extortion,"Puttlam (Puttlam, Chilaw )",4,2,1,7,762396.0,0.0009181580176181406
"Cheating/Misappropriation C.B. Trust over Rs.100,000/=","Puttlam (Puttlam, Chilaw )",32,317,224,573,762396.0,0.07515779201359922
Theft of Property including praedial produce over Rs. 5000/ & cycle cattle theft  irrrespective of their value ,"Puttlam (Puttlam, Chilaw )",447,319,278,1044,762396.0,0.1369367100561913
Counterfeiting Currency,"Puttlam (Puttlam, Chilaw )",0,0,1,1,762396.0,0.00013116543108830582
Offences against  State,"Puttlam (Puttlam, Chilaw )",0,0,0,0,762396.0,0.0
Cruelty to Children & sexual  exploitation of children ,"Puttlam (Puttlam, Chilaw )",7,6,3,16,762396.0,0.002098646897412893
Procuration / Trafficking,"Puttlam (Puttlam, Chilaw )",0,0,0,0,762396.0,0.0
Offences  under the  Offensive weapons Act.,"Puttlam (Puttlam, Chilaw )",4,2,9,15,762396.0,0.001967481466324587
Possession of  Automatic or  Repeater Shot Guns,"Puttlam (Puttlam, Chilaw )",4,5,5,14,762396.0,0.0018363160352362813
"Offences under the  Poisons, Opium & Dangerous Drugs Ord. Quantity  as  indicated in Circular NO. 1540/2000","Puttlam (Puttlam, Chilaw )",6,0,12,18,762396.0,0.002360977759589505
Abduction / Kidnapping,Ratnapura ,45,60,56,161,1088007.0,0.014797698911863619
Arson,Ratnapura ,41,57,50,148,1088007.0,0.013602853658110656
Mischief  over Rs.5000/=,Ratnapura ,69,45,68,182,1088007.0,0.016727833552541482
H.B. & Theft,Ratnapura ,1014,1091,900,3005,1088007.0,0.27619307596366566
Grevious  Hurt,Ratnapura ,100,108,101,309,1088007.0,0.02840055256997427
Hurt  by Knife etc.,Ratnapura ,154,160,198,512,1088007.0,0.04705852076319362
Homicide/Abet. To commit suicide,Ratnapura ,64,58,46,168,1088007.0,0.015441077125422906
Attempted Homicide,Ratnapura ,19,14,19,52,1088007.0,0.004779381015011852
Rape / Incest,Ratnapura ,135,122,130,387,1088007.0,0.03556962409249205
Riot,Ratnapura ,0,0,0,0,1088007.0,0.0
Robbery,Ratnapura ,350,302,295,947,1088007.0,0.08703988117723507
Unnatural Offence/Grve Sexual Abuse,Ratnapura ,56,42,57,155,1088007.0,0.014246231871669943
Extortion,Ratnapura ,2,3,2,7,1088007.0,0.0006433782135592878
"Cheating/Misappropriation C.B. Trust over Rs.100,000/=",Ratnapura ,255,170,248,673,1088007.0,0.061856219675057236
Theft of Property including praedial produce over Rs. 5000/ & cycle cattle theft  irrrespective of their value ,Ratnapura ,463,427,487,1377,1088007.0,0.12656168572444845
Counterfeiting Currency,Ratnapura ,1,1,3,5,1088007.0,0.0004595558668280627
Offences against  State,Ratnapura ,0,0,0,0,1088007.0,0.0
Cruelty to Children & sexual  exploitation of children ,Ratnapura ,3,7,7,17,1088007.0,0.0015624899472154133
Procuration / Trafficking,Ratnapura ,3,0,1,4,1088007.0,0.00036764469346245015
Offences  under the  Offensive weapons Act.,Ratnapura ,11,5,6,22,1088007.0,0.002022045814043476
Possession of  Automatic or  Repeater Shot Guns,Ratnapura ,2,0,1,3,1088007.0,0.00027573352009683757
"Offences under the  Poisons, Opium & Dangerous Drugs Ord. Quantity  as  indicated in Circular NO. 1540/2000",Ratnapura ,21,26,20,67,1088007.0,0.00615804861549604
Abduction / Kidnapping,Hambanthota (Tangalle ),43,44,53,140,599903.0,0.023337106165496755
Arson,Hambanthota (Tangalle ),38,25,23,86,599903.0,0.01433565093023372
Mischief  over Rs.5000/=,Hambanthota (Tangalle ),44,32,33,109,599903.0,0.018169604085993902
H.B. & Theft,Hambanthota (Tangalle ),362,403,487,1252,599903.0,0.2087004065657281
Grevious  Hurt,Hambanthota (Tangalle ),33,30,16,79,599903.0,0.013168795621958882
Hurt  by Knife etc.,Hambanthota (Tangalle ),87,51,56,194,599903.0,0.03233856140075979
Homicide/Abet. To commit suicide,Hambanthota (Tangalle ),43,41,21,105,599903.0,0.017502829624122567
Attempted Homicide,Hambanthota (Tangalle ),10,14,12,36,599903.0,0.0060009701568420224
Rape / Incest,Hambanthota (Tangalle ),77,76,106,259,599903.0,0.043173646406169
Riot,Hambanthota (Tangalle ),0,0,1,1,599903.0,0.00016669361546783396
Robbery,Hambanthota (Tangalle ),216,184,181,581,599903.0,0.09684899058681154
Unnatural Offence/Grve Sexual Abuse,Hambanthota (Tangalle ),24,27,38,89,599903.0,0.014835731776637221
Extortion,Hambanthota (Tangalle ),1,2,2,5,599903.0,0.0008334680773391698
"Cheating/Misappropriation C.B. Trust over Rs.100,000/=",Hambanthota (Tangalle ),51,117,218,386,599903.0,0.06434373557058391
Theft of Property including praedial produce over Rs. 5000/ & cycle cattle theft  irrrespective of their value ,Hambanthota (Tangalle ),252,245,274,771,599903.0,0.1285207775257
Counterfeiting Currency,Hambanthota (Tangalle ),0,1,1,2,599903.0,0.0003333872309356679
Offences against  State,Hambanthota (Tangalle ),0,0,0,0,599903.0,0.0
Cruelty to Children & sexual  exploitation of children ,Hambanthota (Tangalle ),4,0,1,5,599903.0,0.0008334680773391698
Procuration / Trafficking,Hambanthota (Tangalle ),1,0,0,1,599903.0,0.00016669361546783396
Offences  under the  Offensive weapons Act.,Hambanthota (Tangalle ),4,6,8,18,599903.0,0.0030004850784210112
Possession of  Automatic or  Repeater Shot Guns,Hambanthota (Tangalle ),1,2,2,5,599903.0,0.0008334680773391698
"Offences under the  Poisons, Opium & Dangerous Drugs Ord. Quantity  as  indicated in Circular NO. 1540/2000",Hambanthota (Tangalle ),35,24,56,115,599903.0,0.019169765778800908
Abduction / Kidnapping,"Trincomalee (Kantale, Trincomalee )",13,16,17,46,379541.0,0.012119902724606828
Arson,"Trincomalee (Kantale, Trincomalee )",8,16,23,47,379541.0,0.012383378870793932
Mischief  over Rs.5000/=,"Trincomalee (Kantale, Trincomalee )",36,30,18,84,379541.0,0.022131996279716813
H.B. & Theft,"Trincomalee (Kantale, Trincomalee )",227,184,210,621,379541.0,0.16361868678219219
Grevious  Hurt,"Trincomalee (Kantale, Trincomalee )",57,43,50,150,379541.0,0.03952142192806574
Hurt  by Knife etc.,"Trincomalee (Kantale, Trincomalee )",57,40,42,139,379541.0,0.03662318432000759
Homicide/Abet. To commit suicide,"Trincomalee (Kantale, Trincomalee )",9,11,13,33,379541.0,0.008694712824174463
Attempted Homicide,"Trincomalee (Kantale, Trincomalee )",5,4,4,13,379541.0,0.0034251899004323644
Rape / Incest,"Trincomalee (Kantale, Trincomalee )",32,30,39,101,379541.0,0.0266110907648976
Riot,"Trincomalee (Kantale, Trincomalee )",0,2,0,2,379541.0,0.0005269522923742098
Robbery,"Trincomalee (Kantale, Trincomalee )",33,27,35,95,379541.0,0.02503023388777497
Unnatural Offence/Grve Sexual Abuse,"Trincomalee (Kantale, Trincomalee )",19,5,15,39,379541.0,0.010275569701297093
Extortion,"Trincomalee (Kantale, Trincomalee )",1,3,1,5,379541.0,0.0013173807309355247
"Cheating/Misappropriation C.B. Trust over Rs.100,000/=","Trincomalee (Kantale, Trincomalee )",11,71,123,205,379541.0,0.054012609968356516
Theft of Property including praedial produce over Rs. 5000/ & cycle cattle theft  irrrespective of their value ,"Trincomalee (Kantale, Trincomalee )",215,207,176,598,379541.0,0.15755873541988877
Counterfeiting Currency,"Trincomalee (Kantale, Trincomalee )",1,1,0,2,379541.0,0.0005269522923742098
Offences against  State,"Trincomalee (Kantale, Trincomalee )",0,0,0,0,379541.0,0.0
Cruelty to Children & sexual  exploitation of children ,"Trincomalee (Kantale, Trincomalee )",5,7,1,13,379541.0,0.0034251899004323644
Procuration / Trafficking,"Trincomalee (Kantale, Trincomalee )",1,0,0,1,379541.0,0.0002634761461871049
Offences  under the  Offensive weapons Act.,"Trincomalee (Kantale, Trincomalee )",3,2,4,9,379541.0,0.0023712853156839446
Possession of  Automatic or  Repeater Shot Guns,"Trincomalee (Kantale, Trincomalee )",1,0,1,2,379541.0,0.0005269522923742098
"Offences under the  Poisons, Opium & Dangerous Drugs Ord. Quantity  as  indicated in Circular NO. 1540/2000","Trincomalee (Kantale, Trincomalee )",7,6,1,14,379541.0,0.0036886660466194693
Abduction / Kidnapping,Vavuniya ,8,6,10,24,172115.0,0.013944165238358074
Arson,Vavuniya ,6,5,9,20,172115.0,0.01162013769863173
Mischief  over Rs.5000/=,Vavuniya ,10,8,11,29,172115.0,0.016849199663016005
H.B. & Theft,Vavuniya ,89,112,120,321,172115.0,0.18650321006303924
Grevious  Hurt,Vavuniya ,16,15,13,44,172115.0,0.025564302936989802
Hurt  by Knife etc.,Vavuniya ,24,21,6,51,172115.0,0.02963135113151091
Homicide/Abet. To commit suicide,Vavuniya ,8,8,10,26,172115.0,0.01510617900822125
Attempted Homicide,Vavuniya ,2,3,0,5,172115.0,0.0029050344246579324
Rape / Incest,Vavuniya ,25,12,15,52,172115.0,0.0302123580164425
Riot,Vavuniya ,0,0,0,0,172115.0,0.0
Robbery,Vavuniya ,64,38,32,134,172115.0,0.07785492258083258
Unnatural Offence/Grve Sexual Abuse,Vavuniya ,4,0,6,10,172115.0,0.005810068849315865
Extortion,Vavuniya ,3,1,2,6,172115.0,0.0034860413095895186
"Cheating/Misappropriation C.B. Trust over Rs.100,000/=",Vavuniya ,109,133,129,371,172115.0,0.21555355430961856
Theft of Property including praedial produce over Rs. 5000/ & cycle cattle theft  irrrespective of their value ,Vavuniya ,135,104,136,375,172115.0,0.21787758184934491
Counterfeiting Currency,Vavuniya ,0,0,1,1,172115.0,0.0005810068849315865
Offences against  State,Vavuniya ,0,0,1,1,172115.0,0.0005810068849315865
Cruelty to Children & sexual  exploitation of children ,Vavuniya ,10,5,2,17,172115.0,0.00987711704383697
Procuration / Trafficking,Vavuniya ,0,1,1,2,172115.0,0.001162013769863173
Offences  under the  Offensive weapons Act.,Vavuniya ,10,6,9,25,172115.0,0.01452517212328966
Possession of  Automatic or  Repeater Shot Guns,Vavuniya ,1,1,0,2,172115.0,0.001162013769863173
"Offences under the  Poisons, Opium & Dangerous Drugs Ord. Quantity  as  indicated in Circular NO. 1540/2000",Vavuniya ,4,3,5,12,172115.0,0.006972082619179037
